NO tex/Bark.xpm
SO tex/Glass.xpm
WE tex/Grass.xpm
EA tex/Stone.xpm
F 255,0,0
C 0,255,255
                
1111111
1000001
100E001
1111111