NO tex/Bark.xpm
SO tex/Glass.xpm
WE tex/Grass.xpm
EA tex/Stone.xpm
F 255,0,0
C 0,255,255
                
11111111111111111111
10000000000000000001
10111101111101111101
10100001000001000101
10101111011111011101
10100000010000000101
10111111010111110101
10000000010100000101
10111111110101111101
10100000000100000001
10101111111111111001
10100000000000001001
10111110111111101001
10000010100000101001
11110110101110101101
10000100001000100001
10111111111111111101
1000000000N000000001
11111111111111111111
